11111111111111111111111111111111
1........1.......1.........E...1
1..P.....1.......1.............1
1......W.1.................E...1
1.............E................1
11111111..........111111...E...1
1..............1......E........1
1..............111111111.......1
1.EEEEEE..1....................1
1.....1111111..................1
1.....1..........EEE...........1
1....11........................1
1..............................1
1..E..E.E.E.E.E.E.E.E.E.E.E.E..1
1..............................1
1..E..E.E.E.E.E.E.E.E.E.E.E.E..1
1..............................1
1..E..E.E.E.E.E.E.E.E.E.E.E.E..1
1..............................1
1..E..E.E.E.E.E.E.E.E.E.E.E.E..1
1..............................1
1..............................1
1..............................1
11111111111111111111111111111111